####....##
#.........
#.........
....#.#...
..........
..........
#.....#...
#...@.....
#.........
#.........
